Captive Convention
An Interactive Fiction by Brent Uramoto
Release 1 / Serial number 141003 / Inform 7 build 6L38 (I6/v6.33 lib 6/12N) SD

Main Hall
This is the Main Hall of the Convention Center. It has a white marble floor, and white flourecent lights illuminate the hall. There is a plaque on the right wall.  A lot of the rooms connect here. There is a supply closet to the northeast. The Ballroom is to the east. The Announcment booth is to the south. The entrace is to the north.

I beg your pardon?

* * *

Captive Convention
An Interactive Fiction by Brent Uramoto
Release 1 / Serial number 141003 / Inform 7 build 6L38 (I6/v6.33 lib 6/12N) SD

Main Hall
This is the Main Hall of the Convention Center. It has a white marble floor, and white flourecent lights illuminate the hall. There is a plaque on the right wall.  A lot of the rooms connect here. There is a supply closet to the northeast. The Ballroom is to the east. The Announcment booth is to the south. The entrace is to the north.

>open box
You open Small Box, revealing Battery.

* * *

Captive Convention
An Interactive Fiction by Brent Uramoto
Release 1 / Serial number 141003 / Inform 7 build 6L38 (I6/v6.33 lib 6/12N) SD

Main Hall
This is the Main Hall of the Convention Center. It has a white marble floor, and white flourecent lights illuminate the hall. There is a plaque on the right wall.  A lot of the rooms connect here. There is a supply closet to the northeast. The Ballroom is to the east. The Announcment booth is to the south. The entrace is to the north.

>n
Front Desk
This is where everybody enters and exits the convention center. There is a desk where people check in for the conventions. The doors are to the north, and the Main Hall is to the south.

You can see Front door and Small Box here.

>n
(first opening Front door)
It seems to be locked.

>n
(first opening Front door)
It seems to be locked.

>look
Front Desk
You can see Front door here.

>x front door
You see nothing special about Front door.

>open
(Front door)
It seems to be locked.

* * *

>sdf
That's not a verb I recognise.

* * *

>n
Winning Area
You can see Front door here.

* * *

>n
(first opening Front door)
It seems to be locked.

>open front door
That's already open.

* * *

>n
Front Desk
This is where everybody enters and exits the convention center. There is a desk where people check in for the conventions. The doors are to the north, and the Main Hall is to the south.

You can see Front door and Small Box here.

>open box
You open Small Box, revealing Battery1.

>x box
This is a small brown box on the desk. I don't know why it's here.

In Small Box is Battery.

>x battery
This is a AA battery. That looks like it can go into a radio.

>take battery
Taken.

>l
Front Desk
This is where everybody enters and exits the convention center. There is a desk where people check in for the conventions. The doors are to the north, and the Main Hall is to the south.

You can see Front door and Small Box (empty) here.

>n
(first opening Front door)
It seems to be locked.

>s
Main Hall
This is the Main Hall of the Convention Center. It has a white marble floor, and white flourecent lights illuminate the hall. There is a plaque on the right wall.  A lot of the rooms connect here. There is a supply closet to the northeast. The Ballroom is to the east. The Announcment booth is to the south. The entrace is to the north.

>s
Announcment booth
This is where people make announcments during events. There are nice comfy chairs here, and microphone on top of a desk. The microphone used for making announcements. There is also a container underneath the desk.

You can see Wood drawer (closed) here.

* * *

>open box
You open Small Box, revealing Battery1.

>take Battery1
Taken.

>s
Main Hall
This is the Main Hall of the Convention Center. It has a white marble floor, and white flourecent lights illuminate the hall. There is a plaque on the right wall.  A lot of the rooms connect here. There is a supply closet to the northeast. The Ballroom is to the east. The Announcment booth is to the south. The entrace is to the north.

>s
Announcment booth
This is where people make announcments during events. There are nice comfy chairs here, and microphone on top of a desk. The microphone used for making announcements. There is also a container underneath the desk. The office is to the east, and the Main hall is to the north

You can see Wood drawer here.

>open drawer
You open Wood drawer, revealing Radio.

>take radio
Taken.

>e
You can't go that way.

>e
You can't go that way.

>l
Announcment booth
This is where people make announcments during events. There are nice comfy chairs here, and microphone on top of a desk. The microphone used for making announcements. There is also a container underneath the desk. The office is to the east, and the Main hall is to the north

You can see Wood drawer here.

>e
You can't go that way.

* * *

Captive Convention
An Interactive Fiction by Brent Uramoto
Release 1 / Serial number 141003 / Inform 7 build 6L38 (I6/v6.33 lib 6/12N) SD

Main Hall
This is the Main Hall of the Convention Center. It has a white marble floor, and white flourecent lights illuminate the hall. There is a plaque on the right wall.  A lot of the rooms connect here. There is a supply closet to the northeast. The Ballroom is to the east. The Announcment booth is to the south. The entrace is to the north.

>s
Announcement booth
This is where people make announcments during events. There are nice comfy chairs here, and microphone on top of a desk. The microphone used for making announcements. There is also a container underneath the desk. The office is to the east, and the Main hall is to the north

You can see Wood drawer here.

>sit on comfy chaor
I only understood you as far as wanting to sit on Comfy chair.

>sit on comfy chair
I shouldn't sit down now, I gotta get out of here!

* * *

>s
Announcement booth
This is where people make announcments during events. There are nice comfy chairs here, and microphone on top of a desk. The microphone used for making announcements. There is also a container underneath the desk. The office is to the east, and the Main hall is to the north

You can see Wood drawer here.

>sit in comfy chair
That's not something you can sit down on.

* * *

>s
Announcement booth
This is where people make announcments during events. There are nice comfy chairs here, and microphone on top of a desk. The microphone used for making announcements. There is also a container underneath the desk. The office is to the east, and the Main hall is to the north

You can see Wood drawer here.

>e
Office
This looks like the office of the owner of the Convention center.  Nothing special here.

>east
You can't go that way.

>east
You can't go that way.

>l
Office
This looks like the office of the owner of the Convention center.  Nothing special here.

>n
Ballroom
This is where there are events are held. Everything from birthday parties to weddings are held here. The office is to the south. The main hall is to the west.

You can see Battery2 here.

>e
You can't go that way.

>s
Office
This looks like the office of the owner of the Convention center.  Nothing special here.

>w
Announcement booth
This is where people make announcments during events. There are nice comfy chairs here, and microphone on top of a desk. The microphone used for making announcements. There is also a container underneath the desk. The office is to the east, and the Main hall is to the north

You can see Wood drawer here.

>l
Announcement booth
This is where people make announcments during events. There are nice comfy chairs here, and microphone on top of a desk. The microphone used for making announcements. There is also a container underneath the desk. The office is to the east, and the Main hall is to the north

You can see Wood drawer here.

>e
Office
This looks like the office of the owner of the Convention center.  Nothing special here.

>n
Ballroom
This is where there are events are held. Everything from birthday parties to weddings are held here. The office is to the south. The main hall is to the west.

You can see Battery2 here.

>w
Main Hall
This is the Main Hall of the Convention Center. It has a white marble floor, and white flourecent lights illuminate the hall. There is a plaque on the right wall.  A lot of the rooms connect here. There is a supply closet to the northeast. The Ballroom is to the east. The Announcment booth is to the south. The entrace is to the north.

>n
Front Desk
This is where everybody enters and exits the convention center. There is a desk where people check in for the conventions. The doors are to the north, and the Main Hall is to the south.

You can see Front door and Small Box here.

>s
Main Hall
This is the Main Hall of the Convention Center. It has a white marble floor, and white flourecent lights illuminate the hall. There is a plaque on the right wall.  A lot of the rooms connect here. There is a supply closet to the northeast. The Ballroom is to the east. The Announcment booth is to the south. The entrace is to the north.

>x plaque
The plaque reads: In case of emergency, call 232-3345

>n
Front Desk
This is where everybody enters and exits the convention center. There is a desk where people check in for the conventions. The doors are to the north, and the Main Hall is to the south.

You can see Front door and Small Box here.

>open bo
You can't see any such thing.

>open box
You open Small Box, revealing Battery1.

>take battery1
Taken.

>s
Main Hall
This is the Main Hall of the Convention Center. It has a white marble floor, and white flourecent lights illuminate the hall. There is a plaque on the right wall.  A lot of the rooms connect here. There is a supply closet to the northeast. The Ballroom is to the east. The Announcment booth is to the south. The entrace is to the north.

>s
Announcement booth
This is where people make announcments during events. There are nice comfy chairs here, and microphone on top of a desk. The microphone used for making announcements. There is also a container underneath the desk. The office is to the east, and the Main hall is to the north

You can see Wood drawer here.

>open drawer
You open Wood drawer, revealing Radio.

* * *

>take radio
Taken.

>e
Office
This looks like the office of the owner of the Convention center.  Nothing special here.

>l
Office
This looks like the office of the owner of the Convention center.  Nothing special here.

* * *

>n
Ballroom
This is where there are events are held. Everything from birthday parties to weddings are held here. The office is to the south. The main hall is to the west.

You can see Battery2 here.

>take battery2
Taken.

>x radio
This is a radio that can make short calls. I might be able to contact someone who can help me get out of here.There are no batteries in here. Maybe I can find some laying around.

>put battery1 in radio
You put Battery1 into Radio.

>x radio
This is a radio that can make short calls. I might be able to contact someone who can help me get out of here. There is still one battery slot empty.

In Radio is Battery1.

>put battery2 in radio
You put Battery2 into Radio.

>x radio
This is a radio that can make short calls. I might be able to contact someone who can help me get out of here. There is still one battery slot empty. The radio is now operational. Who should I call for help?

In Radio are Battery2 and Battery1.

>232-3345
There is a crackle and a grunt on the other end of the line. "Hello? This is Mr. Morton. Who is this?" (you explain that you are trapped in the convention center) "Oh! Okay. There is a key to the front door in my office. You should look in the drawer on the left side of my desk. Sorry about you getting locked in. It was the security guy's first day on the job." You thank him and hang up.

>e
You can't go that way.

>l
Ballroom
This is where there are events are held. Everything from birthday parties to weddings are held here. The office is to the south. The main hall is to the west.

>s
Office
This looks like the office of the owner of the Convention center.   Mr. Morton said that the key is hidden in his desk.

You can see Secret drawer (in which is Secret key) here.

>take secret key
Taken.

>n
Ballroom
This is where there are events are held. Everything from birthday parties to weddings are held here. The office is to the south. The main hall is to the west.

>e
You can't go that way.

>w
Main Hall
This is the Main Hall of the Convention Center. It has a white marble floor, and white flourecent lights illuminate the hall. There is a plaque on the right wall.  A lot of the rooms connect here. There is a supply closet to the northeast. The Ballroom is to the east. The Announcment booth is to the south. The entrace is to the north.

* * *

>n
(first opening Front door)
It seems to be locked.

>unlcok front door
That's not a verb I recognise.

>unlock front door
What do you want to unlock Front door with?

>unlock front door with secret key
You unlock Front door.

>i
You are carrying:
  Secret key
  Radio
    Battery2
    Battery1

>s
Main Hall
This is the Main Hall of the Convention Center. It has a white marble floor, and white flourecent lights illuminate the hall. There is a plaque on the right wall.  A lot of the rooms connect here. There is a supply closet to the northeast. The Ballroom is to the east. The Announcment booth is to the south. The entrace is to the north.

>e
Ballroom
This is where there are events are held. Everything from birthday parties to weddings are held here. The office is to the south. The main hall is to the west.

>s
Office
This looks like the office of the owner of the Convention center.   Mr. Morton said that the key is hidden in his desk.

You can see Secret drawer here.

>take secret key
You already have that.

>i
You are carrying:
  Secret key
  Radio
    Battery2
    Battery1

>open secret drawer
That's already open.

>take secret key
You already have that.

* * *

>i
You are carrying:
  Secret key
  Radio
    Battery2
    Battery1

>l
Office
This looks like the office of the owner of the Convention center.   Mr. Morton said that the key is hidden in his desk.

You can see Secret drawer here.

>take secret key
You already have that.

* * *

>i
You are carrying:
  Secret key
  Radio
    Battery2
    Battery1

>n
Ballroom
This is where there are events are held. Everything from birthday parties to weddings are held here. The office is to the south. The main hall is to the west.

* * *

>n
Front Desk
This is where everybody enters and exits the convention center. There is a desk where people check in for the conventions. The doors are to the north, and the Main Hall is to the south.

You can see Front door and Small Box here.

>n
(first opening Front door)

Winning Area
I'm free!

You can see Front door here.

    *** You got out of the convention center! Congratulations! ***

Would you like to RESTART, RESTORE a saved game, QUIT or UNDO the last command?

* * *

>take radio
Taken.

>n
Main Hall
This is the Main Hall of the Convention Center. It has a white marble floor, and white flourecent lights illuminate the hall. There is a plaque on the right wall.  A lot of the rooms connect here. There is a supply closet to the northeast. The Ballroom is to the east. The Announcment booth is to the south. The entrace is to the north.

>n
Front Desk
This is where everybody enters and exits the convention center. There is a desk where people check in for the conventions. The doors are to the north, and the Main Hall is to the south.

You can see Front door and Small Box here.

* * *

>open box
You open Small Box, revealing Battery1.

>take battery
You can't see any such thing.

>take battery1
Which do you mean, Battery1 or If Battery1?

>s
I only understood you as far as wanting to take south.

>e
You can't go that way.

>take battery2
You can't see any such thing.

>put battery1 in radio
Which do you mean, Battery1 or If Battery1?

>put battery2 in radio
You can't see any such thing.