You wake up in the dark and check the clock in the corner of the room. Oh my gosh! It is way past the time when you were supposed to leave. You check your sorroundings. You are in a small office in the convention center. Earlier today, you were attending a game convention when you became very tired. You found this office unlocked and took a little nap. You make your way to the entrance and try the doors. Locked. Dang. You walk back to the Main hall. I need to get out, but where do I start?

Captive Convention
An Interactive Fiction by Brent Uramoto
Release 1 / Serial number 141007 / Inform 7 build 6L38 (I6/v6.33 lib 6/12N) SD

Main Hall
This is the Main Hall of the Convention Center. It has a white marble floor, and white flourecent lights illuminate the hall. There is a plaque on the right wall.  A lot of the rooms connect here. The Ballroom is to the east. The Announcment booth is to the south. The entrace is to the north.

I beg your pardon?

* * *

>x lights
Bright white lights. It is hard to look at them directly. Good thing that these are on, otherwise, it would be pitch black.

>x floor
You can't see any such thing.

>n
Front Desk
This is where everybody enters and exits the convention center. There is a desk where people check in for the conventions. The front door is to the north, and the Main Hall is to the south.

You can see Front door and Small Box here.

>x front door
It is glass doors that have a view of the street. So close to freedom, but so far. I cannot break it down, because the owner would get mad at me. I need to find something to unlock this door!

* * *

>x floor
You can't see any such thing.

>x lights\
You can't see any such thing.

>x lights
Bright white lights. It is hard to look at them directly. Good thing that these are on, otherwise, it would be pitch black.

>s
Announcement booth
This is where people make announcments during events. There are nice comfy chairs here, and microphone on top of a desk. The microphone used for making announcements. There is also a wooden drawer underneath the desk. The office is to the east, and the Main hall is to the north

You can see Wood drawer here.

>open wood drawer
You open Wood drawer, revealing Radio.

>x radio
This is a radio that can make short calls. I might be able to contact someone who can help me get out of here.There are no batteries in here. Maybe I can find some laying around.

>n
Main Hall
This is the Main Hall of the Convention Center. It has a white marble floor, and white flourecent lights illuminate the hall. There is a plaque on the right wall.  A lot of the rooms connect here. The Ballroom is to the east. The Announcment booth is to the south. The entrace is to the north.

>e
Ballroom
This is where there are events are held. Everything from birthday parties to weddings are held here. The last remains of the game convention was here. Nothing special to look at though. The office is to the south. The main hall is to the west.

You can see Battery2 here.

>take battery2
Taken.

>s
Office
This looks like the office of the owner of the Convention center. On the other side of the office is a big window of the street. The Ballroom is to the north, and the Announcement booth is to the west.  Nothing special here.

>w
Announcement booth
This is where people make announcments during events. There are nice comfy chairs here, and microphone on top of a desk. The microphone used for making announcements. There is also a wooden drawer underneath the desk. The office is to the east, and the Main hall is to the north

You can see Wood drawer (in which is Radio) here.

>take radio
Taken.

>tn
That's not a verb I recognise.

>n
Main Hall
This is the Main Hall of the Convention Center. It has a white marble floor, and white flourecent lights illuminate the hall. There is a plaque on the right wall.  A lot of the rooms connect here. The Ballroom is to the east. The Announcment booth is to the south. The entrace is to the north.

>w
You can't go that way.

>s
Announcement booth
This is where people make announcments during events. There are nice comfy chairs here, and microphone on top of a desk. The microphone used for making announcements. There is also a wooden drawer underneath the desk. The office is to the east, and the Main hall is to the north

You can see Wood drawer here.

>e
Office
This looks like the office of the owner of the Convention center. On the other side of the office is a big window of the street. The Ballroom is to the north, and the Announcement booth is to the west.  Nothing special here.

I beg your pardon?

>w
Announcement booth
This is where people make announcments during events. There are nice comfy chairs here, and microphone on top of a desk. The microphone used for making announcements. There is also a wooden drawer underneath the desk. The office is to the east, and the Main hall is to the north

You can see Wood drawer here.

>w
You can't go that way.

I beg your pardon?

>n
Main Hall
This is the Main Hall of the Convention Center. It has a white marble floor, and white flourecent lights illuminate the hall. There is a plaque on the right wall.  A lot of the rooms connect here. The Ballroom is to the east. The Announcment booth is to the south. The entrace is to the north.

>n
Front Desk
This is where everybody enters and exits the convention center. There is a desk where people check in for the conventions. The front door is to the north, and the Main Hall is to the south.

You can see Front door and Small Box here.

>x box
This is a small brown box on the desk. I don't know why it's here.

>open box
You open Small Box, revealing Battery1.

>take battery1
Taken.

>Put battery1 in radio
You put Battery1 into Radio.

>put battery2 in radio
You put Battery2 into Radio.

>use radio
That's not a verb I recognise.

>x radio
This is a radio that can make short calls. I might be able to contact someone who can help me get out of here. The radio is now operational. Who should I call for help?

In Radio are Battery2 and Battery1.

>n
(first opening Front door)
It seems to be locked.

>s
Main Hall
This is the Main Hall of the Convention Center. It has a white marble floor, and white flourecent lights illuminate the hall. There is a plaque on the right wall.  A lot of the rooms connect here. The Ballroom is to the east. The Announcment booth is to the south. The entrace is to the north.

>x plaque
The plaque reads: In case of emergency, call 232-3345

>call 232-3345
There is a crackle and a grunt on the other end of the line. "Hello? This is Mr. Morton. Who is this?" (you explain that you are trapped in the convention center) "Oh! Okay. There is a key to the front door in my office. You should look in the drawer on the left side of my desk. Sorry about you getting locked in. It was the security guy's first day on the job." You thank him and hang up.

>n
Front Desk
This is where everybody enters and exits the convention center. There is a desk where people check in for the conventions. The front door is to the north, and the Main Hall is to the south.

You can see Front door and Small Box here.

>open front door
It seems to be locked.

>n
(first opening Front door)
It seems to be locked.

* * *

>s
Main Hall
This is the Main Hall of the Convention Center. It has a white marble floor, and white flourecent lights illuminate the hall. There is a plaque on the right wall.  A lot of the rooms connect here. The Ballroom is to the east. The Announcment booth is to the south. The entrace is to the north.

>s
Announcement booth
This is where people make announcments during events. There are nice comfy chairs here, and microphone on top of a desk. The microphone used for making announcements. There is also a wooden drawer underneath the desk. The office is to the east, and the Main hall is to the north

You can see Wood drawer here.

>w
You can't go that way.

>s
You can't go that way.

>e
Office
This looks like the office of the owner of the Convention center. On the other side of the office is a big window of the street. The Ballroom is to the north, and the Announcement booth is to the west.   Mr. Morton said that the key is hidden in his desk.

You can see Secret drawer (in which is Secret key) here.

>open drawer
That's already open.

>take key
Taken.

>n
Ballroom
This is where there are events are held. Everything from birthday parties to weddings are held here. The last remains of the game convention was here. Nothing special to look at though. The office is to the south. The main hall is to the west.

>n
You can't go that way.

>s
Office
This looks like the office of the owner of the Convention center. On the other side of the office is a big window of the street. The Ballroom is to the north, and the Announcement booth is to the west.   Mr. Morton said that the key is hidden in his desk.

You can see Secret drawer here.

>w
Announcement booth
This is where people make announcments during events. There are nice comfy chairs here, and microphone on top of a desk. The microphone used for making announcements. There is also a wooden drawer underneath the desk. The office is to the east, and the Main hall is to the north

You can see Wood drawer here.

>n
Main Hall
This is the Main Hall of the Convention Center. It has a white marble floor, and white flourecent lights illuminate the hall. There is a plaque on the right wall.  A lot of the rooms connect here. The Ballroom is to the east. The Announcment booth is to the south. The entrace is to the north.

* * *

>n
Front Desk
This is where everybody enters and exits the convention center. There is a desk where people check in for the conventions. The front door is to the north, and the Main Hall is to the south.

You can see Front door and Small Box here.

>unlock front door with key
You unlock Front door.

>open door
You open Front door.

>n
Entranceway
I'm free!

You can see Front door here.

    *** You got out of the convention center! Congratulations! ***

Would you like to RESTART, RESTORE a saved game, QUIT or UNDO the last command?

>undo
Front Desk
[Previous turn undone.]

>x radio
This is a radio that can make short calls. I might be able to contact someone who can help me get out of here. The radio is now operational. Who should I call for help?

In Radio are Battery2 and Battery1.

>take battery1 out of radio
I only understood you as far as wanting to take Battery1.

>take battery1
Taken.

>x radio
This is a radio that can make short calls. I might be able to contact someone who can help me get out of here.There is still one battery slot empty.

In Radio is Battery2.

>232-3345
There is a crackle and a grunt on the other end of the line. "Hello? This is Mr. Morton. Who is this?" (you explain that you are trapped in the convention center) "Oh! Okay. There is a key to the front door in my office. You should look in the drawer on the left side of my desk. Sorry about you getting locked in. It was the security guy's first day on the job." You thank him and hang up.

* * *

>look at plaque
The plaque reads: In case of emergency, call 232-3345

>call 232-3345
 The radio is not working right now because there are no batteries in it!

>go east
Ballroom
This is where there are events are held. Everything from birthday parties to weddings are held here. The last remains of the game convention was here. Nothing special to look at though. The office is to the south. The main hall is to the west.

You can see Battery2 here.

>pick up battery2
Taken.

>go to main hall
You can't see any such thing.

>go west
Main Hall
This is the Main Hall of the Convention Center. It has a white marble floor, and white flourecent lights illuminate the hall. There is a plaque on the right wall.  A lot of the rooms connect here. The Ballroom is to the east. The Announcment booth is to the south. The entrace is to the north.

>call 232-3345
 The radio is not working right now because there are no batteries in it!

>put battery2 in radio
You can't see any such thing.

>inspect radio
That's not a verb I recognise.

>look at radio
You can't see any such thing.

>examine radio
You can't see any such thing.

>insert batteries into radio
You can't see any such thing.

>put battery into radio
You can't see any such thing.

>put Battery2 into radio
You can't see any such thing.

>i
You are carrying:
  Battery2

>put Battery2 into radio
You can't see any such thing.

>x radio
You can't see any such thing.

>i
You are carrying:
  Battery2

>go south
Announcement booth
This is where people make announcments during events. There are nice comfy chairs here, and microphone on top of a desk. The microphone used for making announcements. There is also a wooden drawer underneath the desk. The office is to the east, and the Main hall is to the north

You can see Wood drawer here.

>examine wood drawer
This is a wood drawer used for storing things for the announcers. Nothing specal about it

>open wood drawer
You open Wood drawer, revealing Radio.

>take radio
Taken.

>go east
Office
This looks like the office of the owner of the Convention center. On the other side of the office is a big window of the street. The Ballroom is to the north, and the Announcement booth is to the west.  Nothing special here.

>examine window
It is a view of the main street. Many people and cars pass by. The window is tinted so people on the outside can't look in. So much for trying to get their attention.

>break window
Violence isn't the answer to this one.

>go north
Ballroom
This is where there are events are held. Everything from birthday parties to weddings are held here. The last remains of the game convention was here. Nothing special to look at though. The office is to the south. The main hall is to the west.

>go west
Main Hall
This is the Main Hall of the Convention Center. It has a white marble floor, and white flourecent lights illuminate the hall. There is a plaque on the right wall.  A lot of the rooms connect here. The Ballroom is to the east. The Announcment booth is to the south. The entrace is to the north.

>go north
Front Desk
This is where everybody enters and exits the convention center. There is a desk where people check in for the conventions. The front door is to the north, and the Main Hall is to the south.

You can see Front door and Small Box here.

>open small box
You open Small Box, revealing Battery1.

>take battery1
Taken.

>examine front door
It is glass doors that have a view of the street. So close to freedom, but so far. I cannot break it down, because the owner would get mad at me. I need to find something to unlock this door!

>go south
Main Hall
This is the Main Hall of the Convention Center. It has a white marble floor, and white flourecent lights illuminate the hall. There is a plaque on the right wall.  A lot of the rooms connect here. The Ballroom is to the east. The Announcment booth is to the south. The entrace is to the north.

>put battery1 into radio
You put Battery1 into Radio.

>put battery2 into radio
You put Battery2 into Radio.

>examine plaque
The plaque reads: In case of emergency, call 232-3345

>call 232-3345
There is a crackle and a grunt on the other end of the line. "Hello? This is Mr. Morton. Who is this?" (you explain that you are trapped in the convention center) "Oh! Okay. There is a key to the front door in my office. You should look in the drawer on the left side of my desk. Sorry about you getting locked in. It was the security guy's first day on the job." You thank him and hang up.

>go  east
Ballroom
This is where there are events are held. Everything from birthday parties to weddings are held here. The last remains of the game convention was here. Nothing special to look at though. The office is to the south. The main hall is to the west.

>go south
Office
This looks like the office of the owner of the Convention center. On the other side of the office is a big window of the street. The Ballroom is to the north, and the Announcement booth is to the west.   Mr. Morton said that the key is hidden in his desk.

You can see Secret drawer here.

>open secret drawer
You open Secret drawer, revealing Secret key.

>take secret key
Taken.

>go north
Ballroom
This is where there are events are held. Everything from birthday parties to weddings are held here. The last remains of the game convention was here. Nothing special to look at though. The office is to the south. The main hall is to the west.

* * *

>go north
Front Desk
This is where everybody enters and exits the convention center. There is a desk where people check in for the conventions. The front door is to the north, and the Main Hall is to the south.

You can see Front door and Small Box here.

>open front door
It seems to be locked.

>use key
That's not a verb I recognise.

>put key in front door
That can't contain things.

>go north
(first opening Front door)
It seems to be locked.

>use key to open front door
That's not a verb I recognise.

>use key
That's not a verb I recognise.

>i
You are carrying:
  Secret key
  Radio
    Battery2
    Battery1

>use secret key
That's not a verb I recognise.

>open front door with secret key
You unlock Front door.

>go north
(first opening Front door)

Entranceway
I'm free!

You can see Front door here.

    *** You got out of the convention center! Congratulations! ***

Would you like to RESTART, RESTORE a saved game, QUIT or UNDO the last command?

* * *

>i
You are carrying nothing.

>n
Front Desk
This is where everybody enters and exits the convention center. There is a desk where people check in for the conventions. The front door is to the north, and the Main Hall is to the south.

You can see Front door and Small Box here.

>n
(first opening Front door)
It seems to be locked.

* * *

>s
Main Hall
This is the Main Hall of the Convention Center. It has a white marble floor, and white flourecent lights illuminate the hall. There is a plaque on the right wall.  A lot of the rooms connect here. The Ballroom is to the east. The Announcment booth is to the south. The entrace is to the north.

>n
Front Desk
This is where everybody enters and exits the convention center. There is a desk where people check in for the conventions. The front door is to the north, and the Main Hall is to the south.

You can see Front door and Small Box here.

>take small box
Taken.

>s
Main Hall
This is the Main Hall of the Convention Center. It has a white marble floor, and white flourecent lights illuminate the hall. There is a plaque on the right wall.  A lot of the rooms connect here. The Ballroom is to the east. The Announcment booth is to the south. The entrace is to the north.

>x floor
You can't see any such thing.

>x plaque
The plaque reads: In case of emergency, call 232-3345

>s
Announcement booth
This is where people make announcments during events. There are nice comfy chairs here, and microphone on top of a desk. The microphone used for making announcements. There is also a container underneath the desk. The office is to the east, and the Main hall is to the north

You can see Wood drawer here.

>x microphone
This is the microphone used to make announcements. It seems to be off right now, so I shouldn't waste time trying to call for help on it.

>x container
(Small Box)
This is a small brown box on the desk. I don't know why it's here.

>take small box
You already have that.

>x drawer
This is a wood drawer used for storing things for the announcers. Nothing specal about it

>open drawer
You open Wood drawer, revealing Radio.

>take radio
Taken.

>x radio
This is a radio that can make short calls. I might be able to contact someone who can help me get out of here.There are no batteries in here. Maybe I can find some laying around.

>o
Sorry, that can't be corrected.

>e
Office
This looks like the office of the owner of the Convention center. On the other side of the office is a big window of the street. The Ballroom is to the north, and the Announcement booth is to the west.  Nothing special here.

>x window
It is a view of the main street. Many people and cars pass by. The window is tinted so people on the outside can't look in. So much for trying to get their attention.

>w
Announcement booth
This is where people make announcments during events. There are nice comfy chairs here, and microphone on top of a desk. The microphone used for making announcements. There is also a container underneath the desk. The office is to the east, and the Main hall is to the north

You can see Wood drawer here.

>take wood drawer
Taken.

>l
Announcement booth
This is where people make announcments during events. There are nice comfy chairs here, and microphone on top of a desk. The microphone used for making announcements. There is also a container underneath the desk. The office is to the east, and the Main hall is to the north

>e
Office
This looks like the office of the owner of the Convention center. On the other side of the office is a big window of the street. The Ballroom is to the north, and the Announcement booth is to the west.  Nothing special here.

>b
That's not a verb I recognise.

>n
Ballroom
This is where there are events are held. Everything from birthday parties to weddings are held here. The last remains of the game convention was here. Nothing special to look at though. The office is to the south. The main hall is to the west.

You can see Battery2 here.

>take battery2
Taken.

>e
You can't go that way.

>w
Main Hall
This is the Main Hall of the Convention Center. It has a white marble floor, and white flourecent lights illuminate the hall. There is a plaque on the right wall.  A lot of the rooms connect here. The Ballroom is to the east. The Announcment booth is to the south. The entrace is to the north.

>n
Front Desk
This is where everybody enters and exits the convention center. There is a desk where people check in for the conventions. The front door is to the north, and the Main Hall is to the south.

You can see Front door here.

>x desk
You can't see any such thing.

>s
Main Hall
This is the Main Hall of the Convention Center. It has a white marble floor, and white flourecent lights illuminate the hall. There is a plaque on the right wall.  A lot of the rooms connect here. The Ballroom is to the east. The Announcment booth is to the south. The entrace is to the north.

>s
Announcement booth
This is where people make announcments during events. There are nice comfy chairs here, and microphone on top of a desk. The microphone used for making announcements. There is also a container underneath the desk. The office is to the east, and the Main hall is to the north

>s
You can't go that way.

>e
Office
This looks like the office of the owner of the Convention center. On the other side of the office is a big window of the street. The Ballroom is to the north, and the Announcement booth is to the west.  Nothing special here.

>w
Announcement booth
This is where people make announcments during events. There are nice comfy chairs here, and microphone on top of a desk. The microphone used for making announcements. There is also a container underneath the desk. The office is to the east, and the Main hall is to the north

>w
You can't go that way.

>x container
Which do you mean, Wood drawer, Radio or Small Box?

>small box
This is a small brown box on the desk. I don't know why it's here.

>open small box
You open Small Box, revealing Battery1.

>take battery 1
You can't see any such thing.

>take battery1
Taken.

>put battery1 and battery2 into radio
Battery1: Done.
Battery2: Done.

>x radio
This is a radio that can make short calls. I might be able to contact someone who can help me get out of here. There is still one battery slot empty. The radio is now operational. Who should I call for help?

In Radio are Battery2 and Battery1.

>undo
Announcement booth
[Previous turn undone.]

>undo
Announcement booth
[Previous turn undone.]

>i
You are carrying:
  Battery1
  Battery2
  Wood drawer (open but empty)
  Radio
  Small Box (open but empty)

>put battery1 into radio
You put Battery1 into Radio.

* * *

>put battery2 into radio
You put Battery2 into Radio.

>x radio
This is a radio that can make short calls. I might be able to contact someone who can help me get out of here. There is still one battery slot empty. The radio is now operational. Who should I call for help?

In Radio are Battery2 and Battery1.

>call 232-3345 on radio
I didn't understand that sentence.

>232-3345
There is a crackle and a grunt on the other end of the line. "Hello? This is Mr. Morton. Who is this?" (you explain that you are trapped in the convention center) "Oh! Okay. There is a key to the front door in my office. You should look in the drawer on the left side of my desk. Sorry about you getting locked in. It was the security guy's first day on the job." You thank him and hang up.

>l
Announcement booth
This is where people make announcments during events. There are nice comfy chairs here, and microphone on top of a desk. The microphone used for making announcements. There is also a container underneath the desk. The office is to the east, and the Main hall is to the north

>e
Office
This looks like the office of the owner of the Convention center. On the other side of the office is a big window of the street. The Ballroom is to the north, and the Announcement booth is to the west.   Mr. Morton said that the key is hidden in his desk.

You can see Secret drawer (in which is Secret key) here.

>open secret drawer
That's already open.

>take secret key
Taken.

>x
What do you want to examine?

>s
You see nothing unexpected in that direction.

>w
Announcement booth
This is where people make announcments during events. There are nice comfy chairs here, and microphone on top of a desk. The microphone used for making announcements. There is also a container underneath the desk. The office is to the east, and the Main hall is to the north

>n
Main Hall
This is the Main Hall of the Convention Center. It has a white marble floor, and white flourecent lights illuminate the hall. There is a plaque on the right wall.  A lot of the rooms connect here. The Ballroom is to the east. The Announcment booth is to the south. The entrace is to the north.

>n
Front Desk
This is where everybody enters and exits the convention center. There is a desk where people check in for the conventions. The front door is to the north, and the Main Hall is to the south.

You can see Front door here.

>open front door with secret key
You unlock Front door.

>n
(first opening Front door)

Entranceway
I'm free!

You can see Front door here.

    *** You got out of the convention center! Congratulations! ***

Would you like to RESTART, RESTORE a saved game, QUIT or UNDO the last command?

* * *

>x me
As good-looking as ever.

* * *

>n
Front Desk
This is where everybody enters and exits the convention center. There is a desk where people check in for the conventions. The doors are to the north, and the Main Hall is to the south.

You can see Front door and Small Box here.

>n
(first opening Front door)
It seems to be locked.

>n
(first opening Front door)
It seems to be locked.

>look
Front Desk
You can see Front door here.

>x front door
You see nothing special about Front door.

>open
(Front door)
It seems to be locked.

* * *

>sdf
That's not a verb I recognise.

* * *

>n
Winning Area
You can see Front door here.

* * *

>n
(first opening Front door)
It seems to be locked.

>open front door
That's already open.

* * *

>n
Front Desk
This is where everybody enters and exits the convention center. There is a desk where people check in for the conventions. The doors are to the north, and the Main Hall is to the south.

You can see Front door and Small Box here.

>open box
You open Small Box, revealing Battery1.

>x box
This is a small brown box on the desk. I don't know why it's here.

In Small Box is Battery.

>x battery
This is a AA battery. That looks like it can go into a radio.

>take battery
Taken.

>l
Front Desk
This is where everybody enters and exits the convention center. There is a desk where people check in for the conventions. The doors are to the north, and the Main Hall is to the south.

You can see Front door and Small Box (empty) here.

>n
(first opening Front door)
It seems to be locked.

>s
Main Hall
This is the Main Hall of the Convention Center. It has a white marble floor, and white flourecent lights illuminate the hall. There is a plaque on the right wall.  A lot of the rooms connect here. There is a supply closet to the northeast. The Ballroom is to the east. The Announcment booth is to the south. The entrace is to the north.

>s
Announcment booth
This is where people make announcments during events. There are nice comfy chairs here, and microphone on top of a desk. The microphone used for making announcements. There is also a container underneath the desk.

You can see Wood drawer (closed) here.

* * *

>open box
You open Small Box, revealing Battery1.

>take Battery1
Taken.

>s
Main Hall
This is the Main Hall of the Convention Center. It has a white marble floor, and white flourecent lights illuminate the hall. There is a plaque on the right wall.  A lot of the rooms connect here. There is a supply closet to the northeast. The Ballroom is to the east. The Announcment booth is to the south. The entrace is to the north.

>s
Announcment booth
This is where people make announcments during events. There are nice comfy chairs here, and microphone on top of a desk. The microphone used for making announcements. There is also a container underneath the desk. The office is to the east, and the Main hall is to the north

You can see Wood drawer here.

>open drawer
You open Wood drawer, revealing Radio.

* * *

>take radio
Taken.

>e
You can't go that way.

>e
You can't go that way.

>l
Announcment booth
This is where people make announcments during events. There are nice comfy chairs here, and microphone on top of a desk. The microphone used for making announcements. There is also a container underneath the desk. The office is to the east, and the Main hall is to the north

You can see Wood drawer here.

>e
You can't go that way.

* * *

>open box
You open Small Box, revealing Battery.

* * *

>x plaque
The plaque reads: In case of emergency, call 232-3345

>e
Ballroom
This is where there are events are held. Everything from birthday parties to weddings are held here. The last remains of the game convention was here. Nothing special to look at though. The office is to the south. The main hall is to the west.

You can see Battery2 here.

>take battery
You can't see any such thing.

>take battery2
Taken.

I beg your pardon?

* * *

>s
Announcement booth
This is where people make announcments during events. There are nice comfy chairs here, and microphone on top of a desk. The microphone used for making announcements. There is also a container underneath the desk. The office is to the east, and the Main hall is to the north

You can see Wood drawer here.

>x chairs
You can't see any such thing.

>x microphone
You can't see any such thing.

>x continer
You can't see any such thing.

>x container
This is a wood drawer used for storing things for the announcers. Nothing specal about it

>take container
Taken.

>open the container
You open Wood drawer, revealing Radio.

>open wood drawer
That's already open.

>x wood drawer
This is a wood drawer used for storing things for the announcers. Nothing specal about it

In Wood drawer is Radio.

>take radio
Taken.

>use radio
That's not a verb I recognise.

>l
Announcement booth
This is where people make announcments during events. There are nice comfy chairs here, and microphone on top of a desk. The microphone used for making announcements. There is also a container underneath the desk. The office is to the east, and the Main hall is to the north

>x radio
This is a radio that can make short calls. I might be able to contact someone who can help me get out of here.There are no batteries in here. Maybe I can find some laying around.

>e
Office
This looks like the office of the owner of the Convention center. On the other side of the office is a big window of the street.  Nothing special here.

>x window
It is a view of the main street. Many people and cars pass by. The window is tinted so people on the outside can't look in. So much for trying to get their attention.

>n
Ballroom
This is where there are events are held. Everything from birthday parties to weddings are held here. The last remains of the game convention was here. Nothing special to look at though. The office is to the south. The main hall is to the west.

You can see Battery2 here.

* * *

>take battery2
Taken.

>x battery2
This is an AA battery. That looks like it can go into a radio.

>put battery in radio
You can't see any such thing.

>i
You are carrying:
  Battery2
  Radio
  Wood drawer (open but empty)

>put battery2 in radio
You put Battery2 into Radio.

>e
You can't go that way.

>s
Office
This looks like the office of the owner of the Convention center. On the other side of the office is a big window of the street.  Nothing special here.

>w
Announcement booth
This is where people make announcments during events. There are nice comfy chairs here, and microphone on top of a desk. The microphone used for making announcements. There is also a container underneath the desk. The office is to the east, and the Main hall is to the north

* * *

>n
Front Desk
This is where everybody enters and exits the convention center. There is a desk where people check in for the conventions. The front door is to the north, and the Main Hall is to the south.

You can see Front door and Small Box here.

>x desk
You can't see any such thing.

>x door
It is glass doors that have a view of the street. So close to freedom, but so far. I cannot break it down, because the owner would get mad at me. I need to find something to unlock this door!

>x box
This is a small brown box on the desk. I don't know why it's here.

* * *

>open box
You open Small Box, revealing Battery1.

>put Battery1 in radio
(first taking Battery1)
You put Battery1 into Radio.

I beg your pardon?

>l
Front Desk
This is where everybody enters and exits the convention center. There is a desk where people check in for the conventions. The front door is to the north, and the Main Hall is to the south.

You can see Front door and Small Box here.

>s
Main Hall
This is the Main Hall of the Convention Center. It has a white marble floor, and white flourecent lights illuminate the hall. There is a plaque on the right wall.  A lot of the rooms connect here. The Ballroom is to the east. The Announcment booth is to the south. The entrace is to the north.

* * *

>call 232-3345
There is a crackle and a grunt on the other end of the line. "Hello? This is Mr. Morton. Who is this?" (you explain that you are trapped in the convention center) "Oh! Okay. There is a key to the front door in my office. You should look in the drawer on the left side of my desk. Sorry about you getting locked in. It was the security guy's first day on the job." You thank him and hang up.

>w
You can't go that way.

>l
Main Hall
This is the Main Hall of the Convention Center. It has a white marble floor, and white flourecent lights illuminate the hall. There is a plaque on the right wall.  A lot of the rooms connect here. The Ballroom is to the east. The Announcment booth is to the south. The entrace is to the north.

>e
Ballroom
This is where there are events are held. Everything from birthday parties to weddings are held here. The last remains of the game convention was here. Nothing special to look at though. The office is to the south. The main hall is to the west.

>s
Office
This looks like the office of the owner of the Convention center. On the other side of the office is a big window of the street.   Mr. Morton said that the key is hidden in his desk.

You can see Secret drawer (in which is Secret key) here.

>open drawer
(Wood drawer)
That's already open.

>take key
Taken.

* * *

>n
Ballroom
This is where there are events are held. Everything from birthday parties to weddings are held here. The last remains of the game convention was here. Nothing special to look at though. The office is to the south. The main hall is to the west.

>w
Main Hall
This is the Main Hall of the Convention Center. It has a white marble floor, and white flourecent lights illuminate the hall. There is a plaque on the right wall.  A lot of the rooms connect here. The Ballroom is to the east. The Announcment booth is to the south. The entrace is to the north.

>n
Front Desk
This is where everybody enters and exits the convention center. There is a desk where people check in for the conventions. The front door is to the north, and the Main Hall is to the south.

You can see Front door and Small Box here.

* * *

>open front door
It seems to be locked.

>unlock front door
What do you want to unlock Front door with?

>use key to unlock the front door
You can't see any such thing.

>x front door
It is glass doors that have a view of the street. So close to freedom, but so far. I cannot break it down, because the owner would get mad at me. I need to find something to unlock this door!

>unlock front door with key
You unlock Front door.

>n
(first opening Front door)

Entranceway
I'm free!

You can see Front door here.

    *** You got out of the convention center! Congratulations! ***

Would you like to RESTART, RESTORE a saved game, QUIT or UNDO the last command?

* * *

>s
Announcement booth
This is where people make announcments during events. There are nice comfy chairs here, and microphone on top of a desk. The microphone used for making announcements. There is also a container underneath the desk. The office is to the east, and the Main hall is to the north

You can see Wood drawer here.

>sit on comfy chaor
I only understood you as far as wanting to sit on Comfy chair.

>sit on comfy chair
I shouldn't sit down now, I gotta get out of here!

* * *

>s
Announcement booth
This is where people make announcments during events. There are nice comfy chairs here, and microphone on top of a desk. The microphone used for making announcements. There is also a container underneath the desk. The office is to the east, and the Main hall is to the north

You can see Wood drawer here.

>sit in comfy chair
That's not something you can sit down on.

* * *

>s
Announcement booth
This is where people make announcments during events. There are nice comfy chairs here, and microphone on top of a desk. The microphone used for making announcements. There is also a container underneath the desk. The office is to the east, and the Main hall is to the north

You can see Wood drawer here.

>e
Office
This looks like the office of the owner of the Convention center.  Nothing special here.

>east
You can't go that way.

>east
You can't go that way.

>l
Office
This looks like the office of the owner of the Convention center.  Nothing special here.

>n
Ballroom
This is where there are events are held. Everything from birthday parties to weddings are held here. The office is to the south. The main hall is to the west.

You can see Battery2 here.

>e
You can't go that way.

>s
Office
This looks like the office of the owner of the Convention center.  Nothing special here.

>w
Announcement booth
This is where people make announcments during events. There are nice comfy chairs here, and microphone on top of a desk. The microphone used for making announcements. There is also a container underneath the desk. The office is to the east, and the Main hall is to the north

You can see Wood drawer here.

>l
Announcement booth
This is where people make announcments during events. There are nice comfy chairs here, and microphone on top of a desk. The microphone used for making announcements. There is also a container underneath the desk. The office is to the east, and the Main hall is to the north

You can see Wood drawer here.

>e
Office
This looks like the office of the owner of the Convention center.  Nothing special here.

>n
Ballroom
This is where there are events are held. Everything from birthday parties to weddings are held here. The office is to the south. The main hall is to the west.

You can see Battery2 here.

>w
Main Hall
This is the Main Hall of the Convention Center. It has a white marble floor, and white flourecent lights illuminate the hall. There is a plaque on the right wall.  A lot of the rooms connect here. There is a supply closet to the northeast. The Ballroom is to the east. The Announcment booth is to the south. The entrace is to the north.

>n
Front Desk
This is where everybody enters and exits the convention center. There is a desk where people check in for the conventions. The doors are to the north, and the Main Hall is to the south.

You can see Front door and Small Box here.

>s
Main Hall
This is the Main Hall of the Convention Center. It has a white marble floor, and white flourecent lights illuminate the hall. There is a plaque on the right wall.  A lot of the rooms connect here. There is a supply closet to the northeast. The Ballroom is to the east. The Announcment booth is to the south. The entrace is to the north.

>x plaque
The plaque reads: In case of emergency, call 232-3345

>n
Front Desk
This is where everybody enters and exits the convention center. There is a desk where people check in for the conventions. The doors are to the north, and the Main Hall is to the south.

You can see Front door and Small Box here.

>open bo
You can't see any such thing.

>open box
You open Small Box, revealing Battery1.

* * *

>take battery1
Taken.

>s
Main Hall
This is the Main Hall of the Convention Center. It has a white marble floor, and white flourecent lights illuminate the hall. There is a plaque on the right wall.  A lot of the rooms connect here. There is a supply closet to the northeast. The Ballroom is to the east. The Announcment booth is to the south. The entrace is to the north.

>s
Announcement booth
This is where people make announcments during events. There are nice comfy chairs here, and microphone on top of a desk. The microphone used for making announcements. There is also a container underneath the desk. The office is to the east, and the Main hall is to the north

You can see Wood drawer here.

>open drawer
You open Wood drawer, revealing Radio.

* * *

>take radio
Taken.

>e
Office
This looks like the office of the owner of the Convention center.  Nothing special here.

>l
Office
This looks like the office of the owner of the Convention center.  Nothing special here.

* * *

>n
Ballroom
This is where there are events are held. Everything from birthday parties to weddings are held here. The office is to the south. The main hall is to the west.

You can see Battery2 here.

>take battery2
Taken.

>x radio
This is a radio that can make short calls. I might be able to contact someone who can help me get out of here.There are no batteries in here. Maybe I can find some laying around.

>put battery1 in radio
You put Battery1 into Radio.

>x radio
This is a radio that can make short calls. I might be able to contact someone who can help me get out of here. There is still one battery slot empty.

In Radio is Battery1.

>put battery2 in radio
You put Battery2 into Radio.

>x radio
This is a radio that can make short calls. I might be able to contact someone who can help me get out of here. There is still one battery slot empty. The radio is now operational. Who should I call for help?

In Radio are Battery2 and Battery1.

>232-3345
There is a crackle and a grunt on the other end of the line. "Hello? This is Mr. Morton. Who is this?" (you explain that you are trapped in the convention center) "Oh! Okay. There is a key to the front door in my office. You should look in the drawer on the left side of my desk. Sorry about you getting locked in. It was the security guy's first day on the job." You thank him and hang up.

>e
You can't go that way.

>l
Ballroom
This is where there are events are held. Everything from birthday parties to weddings are held here. The office is to the south. The main hall is to the west.

>s
Office
This looks like the office of the owner of the Convention center.   Mr. Morton said that the key is hidden in his desk.

You can see Secret drawer (in which is Secret key) here.

>take secret key
Taken.

>n
Ballroom
This is where there are events are held. Everything from birthday parties to weddings are held here. The office is to the south. The main hall is to the west.

>e
You can't go that way.

>w
Main Hall
This is the Main Hall of the Convention Center. It has a white marble floor, and white flourecent lights illuminate the hall. There is a plaque on the right wall.  A lot of the rooms connect here. There is a supply closet to the northeast. The Ballroom is to the east. The Announcment booth is to the south. The entrace is to the north.

* * *

>n
(first opening Front door)
It seems to be locked.

>unlcok front door
That's not a verb I recognise.

>unlock front door
What do you want to unlock Front door with?

>unlock front door with secret key
You unlock Front door.

>i
You are carrying:
  Secret key
  Radio
    Battery2
    Battery1

>s
Main Hall
This is the Main Hall of the Convention Center. It has a white marble floor, and white flourecent lights illuminate the hall. There is a plaque on the right wall.  A lot of the rooms connect here. There is a supply closet to the northeast. The Ballroom is to the east. The Announcment booth is to the south. The entrace is to the north.

>e
Ballroom
This is where there are events are held. Everything from birthday parties to weddings are held here. The office is to the south. The main hall is to the west.

>s
Office
This looks like the office of the owner of the Convention center.   Mr. Morton said that the key is hidden in his desk.

You can see Secret drawer here.

>take secret key
You already have that.

>i
You are carrying:
  Secret key
  Radio
    Battery2
    Battery1

>open secret drawer
That's already open.

>take secret key
You already have that.

* * *

>i
You are carrying:
  Secret key
  Radio
    Battery2
    Battery1

>l
Office
This looks like the office of the owner of the Convention center.   Mr. Morton said that the key is hidden in his desk.

You can see Secret drawer here.

>take secret key
You already have that.

* * *

>i
You are carrying:
  Secret key
  Radio
    Battery2
    Battery1

>n
Ballroom
This is where there are events are held. Everything from birthday parties to weddings are held here. The office is to the south. The main hall is to the west.

* * *

>n
Front Desk
This is where everybody enters and exits the convention center. There is a desk where people check in for the conventions. The doors are to the north, and the Main Hall is to the south.

You can see Front door and Small Box here.

>n
(first opening Front door)

Winning Area
I'm free!

You can see Front door here.

    *** You got out of the convention center! Congratulations! ***

Would you like to RESTART, RESTORE a saved game, QUIT or UNDO the last command?

* * *

>take radio
Taken.

>n
Main Hall
This is the Main Hall of the Convention Center. It has a white marble floor, and white flourecent lights illuminate the hall. There is a plaque on the right wall.  A lot of the rooms connect here. There is a supply closet to the northeast. The Ballroom is to the east. The Announcment booth is to the south. The entrace is to the north.

>n
Front Desk
This is where everybody enters and exits the convention center. There is a desk where people check in for the conventions. The doors are to the north, and the Main Hall is to the south.

You can see Front door and Small Box here.

* * *

>open box
You open Small Box, revealing Battery1.

>take battery
You can't see any such thing.

>take battery1
Which do you mean, Battery1 or If Battery1?

>s
I only understood you as far as wanting to take south.

>e
You can't go that way.

>take battery2
You can't see any such thing.

>put battery1 in radio
Which do you mean, Battery1 or If Battery1?

>put battery2 in radio
You can't see any such thing.